R 1040 720
NO ./img/NO.xpm
SO ./img/SO.xpm
WE ./img/WE.xpm
EA ./img/EA.xpm

S ./img/item.xpm
F ./img/FLOOR.xpm
C ./img/CEILING.xpm

        1111111111111111111111111
        1000000000110000000220001
        1011000001110000002220001
        10010000000000E0000202001
111111111011000001110000000020001
100000000011000001110111111111111
11110111111111011100000000001
11110111111111011101010000001
11000000110101011100000010001
10002000000000001100000010001
10000000000000001101010010001
1100000111010101111101111000111
11110111 1110101 10111101001
11111111 1111111 111111111111
