R 1080 720
NO ./img/NO.xpm
SO ./img/SO.xpm
WE ./img/WE.xpm
EA ./img/EA.xpm

S ./img/item.xpm
F 220,100,0
C 0,100,220

        11111111111111111111111111111
        100000000011000000022000100011111
        101100000111000000202000000000001
        10010000000000E00002020010000111
111111111011000001110000000020001002001
1000000000110000011101111111111110000021
11110111111111011100000000001   11111111
11110111111111011101010000001
11000000110101011100000010001
10002000000000001100000010001
10000000000000001101010010001
1100000111010101111101111000111
11110111 1110101 10111101001
11111111 1111111 111111111111
