R 1080 720
NO ./img/wall_n.xpm
SO ./img/wall_s.xpm
WE ./img/wall_e.xpm
EA ./img/wall_w.xpm

S ./img/item.xpm
F 220,100,0
C 225,30,0
        1111111111111111111111111
        1000000000110000000220001
        1011000001110000002220001
        10010000000000E0000202001
111111111011000001110000000020001
100000000011000001110111111111111
111101111111110111000000000001
111101111111110111010100000011
11000000110101011100000010001
10002000000000001100000010001
10000000000000001101010010001
1100000111010101111101111000111
10010111 1110101 10111101001
11111111 1111111 111111111111
